{
  "name": "Experimental Level",
  "field"      : [
    [5, 5, 5, 5, 5, 5, 5, 5],
    [5, 5, 5, 5, 5, 5, 5, 5],
    [5, 5, 5, 5, 5, 5, 5, 5],
    [5, 5, 5, 5, 5, 5, 5, 5],
    [1, 4, 3, 3, 0, 3, 3, 2],
    [5, 5, 5, 5, 5, 5, 5, 5],
    [5, 5, 5, 5, 5, 5, 5, 5],
    [5, 5, 5, 5, 5, 5, 5, 5]
  ],
  "botRotation": 1
}

